"Date","No.","Description","Debit","Credit","RunningBalance"
"2019/05/05","","INTEREST EARNED","","7.29","4036.87"
"2019/05/03","","PAYMENT FROM NASA","","37.71","4029.58"
"2019/05/01","","PAYMENT FROM NASA","","991.87","3991.87"
"2019/04/18","","PAYMENT FROM JONES TOM NATWEST","","2000.00","3000.00"
"2019/04/18","","SENDING MONEY TO MR TOM JONES NATWEST","2000.00","","1000.00"
"2019/04/11","","SENDING MONEY TO MR TOM JONES NATWEST","21.89","","3000.00"
